5 10
# . . R # # # # # #
# # . # . . . . # .
. # . # . # # . # .
. . . . . # # . . .
# # . # # # . C # .