5 5
# . . R #
# # . # .
. # . # .
. . . . .
# # C # #